07
25
#######>########???####??
#.....m@.m.....#???#..#??
#.....m........#####..###
#.....mmm....../........#
#...m.......$..#####....#
#......B.......#???#....#
################???######
10
